..........
..H.....N.
..........
..........
.....E....
..........
.M.......G
..........
..........
.....X....