..........
..M.....E.
..........
..........
.....X....
..........
.G.......H
..........
..........
.....N....