..........
..E.....M.
..........
..........
.....H....
..........
.N.......G
..........
..........
.....X....