..........
..N.....E.
..........
..........
.....H....
..........
.X.......G
..........
..........
.....M....