..........
..X.....E.
..........
..........
.....G....
..........
.H.......N
..........
..........
.....M....