..........
..N.....M.
..........
..........
.....X....
..........
.E.......H
..........
..........
.....G....