..........
..N.....G.
..........
..........
.....M....
..........
.E.......X
..........
..........
.....H....