..........
..H.....G.
..........
..........
.....E....
..........
.N.......X
..........
..........
.....M....