..........
..G.....M.
..........
..........
.....N....
..........
.E.......H
..........
..........
.....X....