..........
..M.....G.
..........
..........
.....X....
..........
.H.......N
..........
..........
.....E....