..........
..M.....G.
..........
..........
.....H....
..........
.E.......N
..........
..........
.....X....