..........
..N.....H.
..........
..........
.....E....
..........
.G.......M
..........
..........
.....X....