..........
..E.....G.
..........
..........
.....M....
..........
.N.......X
..........
..........
.....H....