..........
..X.....N.
..........
..........
.....H....
..........
.M.......E
..........
..........
.....G....