..........
..G.....M.
..........
..........
.....H....
..........
.X.......N
..........
..........
.....E....