..........
..H.....N.
..........
..........
.....G....
..........
.E.......M
..........
..........
.....X....