..........
..M.....H.
..........
..........
.....X....
..........
.E.......G
..........
..........
.....N....