..........
..H.....E.
..........
..........
.....G....
..........
.N.......M
..........
..........
.....X....