..........
..E.....M.
..........
..........
.....G....
..........
.H.......N
..........
..........
.....X....