..........
..E.....H.
..........
..........
.....M....
..........
.N.......G
..........
..........
.....X....