..........
..G.....H.
..........
..........
.....E....
..........
.X.......M
..........
..........
.....N....