..........
..E.....G.
..........
..........
.....X....
..........
.M.......H
..........
..........
.....N....