..........
..M.....H.
..........
..........
.....E....
..........
.X.......N
..........
..........
.....G....