..........
..G.....N.
..........
..........
.....M....
..........
.X.......H
..........
..........
.....E....