..........
..N.....H.
..........
..........
.....M....
..........
.E.......X
..........
..........
.....G....