..........
..G.....N.
..........
..........
.....M....
..........
.E.......H
..........
..........
.....X....