..........
..H.....M.
..........
..........
.....G....
..........
.N.......E
..........
..........
.....X....