..........
..H.....E.
..........
..........
.....X....
..........
.G.......N
..........
..........
.....M....