..........
..G.....H.
..........
..........
.....X....
..........
.M.......E
..........
..........
.....N....