..........
..X.....M.
..........
..........
.....E....
..........
.G.......H
..........
..........
.....N....