..........
..N.....E.
..........
..........
.....G....
..........
.M.......X
..........
..........
.....H....