..........
..X.....N.
..........
..........
.....M....
..........
.G.......H
..........
..........
.....E....