..........
..E.....G.
..........
..........
.....M....
..........
.N.......H
..........
..........
.....X....