..........
..E.....G.
..........
..........
.....H....
..........
.M.......X
..........
..........
.....N....