..........
..H.....X.
..........
..........
.....N....
..........
.G.......E
..........
..........
.....M....