..........
..X.....H.
..........
..........
.....M....
..........
.N.......G
..........
..........
.....E....