..........
..X.....E.
..........
..........
.....H....
..........
.M.......N
..........
..........
.....G....