..........
..N.....X.
..........
..........
.....G....
..........
.M.......E
..........
..........
.....H....