..........
..N.....H.
..........
..........
.....E....
..........
.G.......X
..........
..........
.....M....