..........
..G.....M.
..........
..........
.....X....
..........
.H.......E
..........
..........
.....N....