..........
..M.....N.
..........
..........
.....E....
..........
.G.......H
..........
..........
.....X....