..........
..E.....H.
..........
..........
.....N....
..........
.X.......G
..........
..........
.....M....