..........
..E.....G.
..........
..........
.....H....
..........
.M.......N
..........
..........
.....X....