..........
..G.....H.
..........
..........
.....X....
..........
.N.......E
..........
..........
.....M....