..........
..M.....E.
..........
..........
.....G....
..........
.H.......X
..........
..........
.....N....