..........
..H.....M.
..........
..........
.....G....
..........
.E.......X
..........
..........
.....N....