..........
..N.....G.
..........
..........
.....E....
..........
.H.......X
..........
..........
.....M....