..........
..G.....E.
..........
..........
.....X....
..........
.N.......H
..........
..........
.....M....