..........
..E.....H.
..........
..........
.....G....
..........
.N.......M
..........
..........
.....X....