..........
..N.....M.
..........
..........
.....E....
..........
.G.......X
..........
..........
.....H....