..........
..E.....M.
..........
..........
.....H....
..........
.X.......G
..........
..........
.....N....