..........
..H.....G.
..........
..........
.....M....
..........
.E.......X
..........
..........
.....N....