..........
..N.....X.
..........
..........
.....E....
..........
.M.......G
..........
..........
.....H....