..........
..G.....N.
..........
..........
.....M....
..........
.X.......E
..........
..........
.....H....