..........
..X.....N.
..........
..........
.....E....
..........
.G.......M
..........
..........
.....H....