..........
..N.....H.
..........
..........
.....M....
..........
.G.......E
..........
..........
.....X....