..........
..E.....M.
..........
..........
.....X....
..........
.G.......H
..........
..........
.....N....