..........
..E.....X.
..........
..........
.....M....
..........
.H.......G
..........
..........
.....N....