..........
..M.....H.
..........
..........
.....G....
..........
.E.......N
..........
..........
.....X....