..........
..N.....M.
..........
..........
.....H....
..........
.X.......E
..........
..........
.....G....