..........
..E.....M.
..........
..........
.....G....
..........
.N.......X
..........
..........
.....H....