..........
..H.....E.
..........
..........
.....G....
..........
.M.......N
..........
..........
.....X....