..........
..X.....H.
..........
..........
.....G....
..........
.N.......E
..........
..........
.....M....