..........
..X.....E.
..........
..........
.....H....
..........
.M.......G
..........
..........
.....N....