..........
..H.....G.
..........
..........
.....E....
..........
.M.......X
..........
..........
.....N....