..........
..E.....X.
..........
..........
.....H....
..........
.G.......M
..........
..........
.....N....