..........
..M.....E.
..........
..........
.....G....
..........
.H.......N
..........
..........
.....X....