..........
..M.....X.
..........
..........
.....G....
..........
.H.......E
..........
..........
.....N....