..........
..H.....X.
..........
..........
.....M....
..........
.N.......G
..........
..........
.....E....