..........
..X.....H.
..........
..........
.....M....
..........
.G.......N
..........
..........
.....E....