..........
..X.....M.
..........
..........
.....H....
..........
.G.......E
..........
..........
.....N....