..........
..N.....G.
..........
..........
.....E....
..........
.H.......M
..........
..........
.....X....