..........
..H.....X.
..........
..........
.....G....
..........
.E.......N
..........
..........
.....M....