..........
..H.....E.
..........
..........
.....N....
..........
.G.......X
..........
..........
.....M....