..........
..G.....H.
..........
..........
.....E....
..........
.N.......X
..........
..........
.....M....