..........
..X.....M.
..........
..........
.....N....
..........
.H.......G
..........
..........
.....E....