..........
..H.....X.
..........
..........
.....E....
..........
.G.......N
..........
..........
.....M....