..........
..X.....H.
..........
..........
.....N....
..........
.M.......E
..........
..........
.....G....