..........
..M.....G.
..........
..........
.....X....
..........
.E.......H
..........
..........
.....N....