..........
..X.....N.
..........
..........
.....E....
..........
.H.......G
..........
..........
.....M....