..........
..N.....H.
..........
..........
.....M....
..........
.X.......G
..........
..........
.....E....