..........
..H.....M.
..........
..........
.....N....
..........
.X.......E
..........
..........
.....G....