..........
..N.....G.
..........
..........
.....H....
..........
.X.......E
..........
..........
.....M....