..........
..G.....X.
..........
..........
.....M....
..........
.H.......E
..........
..........
.....N....