..........
..E.....H.
..........
..........
.....N....
..........
.M.......G
..........
..........
.....X....