..........
..G.....N.
..........
..........
.....E....
..........
.M.......X
..........
..........
.....H....