..........
..X.....N.
..........
..........
.....M....
..........
.E.......H
..........
..........
.....G....