..........
..M.....X.
..........
..........
.....G....
..........
.H.......N
..........
..........
.....E....