..........
..X.....E.
..........
..........
.....N....
..........
.G.......M
..........
..........
.....H....