..........
..H.....M.
..........
..........
.....G....
..........
.X.......N
..........
..........
.....E....