..........
..N.....H.
..........
..........
.....G....
..........
.M.......E
..........
..........
.....X....