..........
..N.....G.
..........
..........
.....X....
..........
.E.......M
..........
..........
.....H....