..........
..E.....M.
..........
..........
.....X....
..........
.H.......G
..........
..........
.....N....