..........
..M.....H.
..........
..........
.....G....
..........
.X.......E
..........
..........
.....N....