..........
..E.....G.
..........
..........
.....M....
..........
.H.......N
..........
..........
.....X....