..........
..H.....N.
..........
..........
.....M....
..........
.E.......X
..........
..........
.....G....