..........
..G.....H.
..........
..........
.....E....
..........
.N.......M
..........
..........
.....X....