..........
..N.....X.
..........
..........
.....E....
..........
.H.......M
..........
..........
.....G....