..........
..X.....E.
..........
..........
.....G....
..........
.N.......M
..........
..........
.....H....