..........
..E.....N.
..........
..........
.....X....
..........
.H.......M
..........
..........
.....G....