..........
..G.....H.
..........
..........
.....N....
..........
.X.......M
..........
..........
.....E....