..........
..E.....N.
..........
..........
.....M....
..........
.G.......H
..........
..........
.....X....