..........
..E.....X.
..........
..........
.....G....
..........
.N.......M
..........
..........
.....H....