..........
..G.....X.
..........
..........
.....M....
..........
.E.......H
..........
..........
.....N....