..........
..E.....M.
..........
..........
.....X....
..........
.G.......N
..........
..........
.....H....