..........
..G.....N.
..........
..........
.....E....
..........
.H.......X
..........
..........
.....M....