..........
..N.....E.
..........
..........
.....G....
..........
.H.......X
..........
..........
.....M....