..........
..G.....X.
..........
..........
.....E....
..........
.N.......H
..........
..........
.....M....