..........
..H.....M.
..........
..........
.....X....
..........
.G.......N
..........
..........
.....E....