..........
..G.....H.
..........
..........
.....N....
..........
.X.......E
..........
..........
.....M....