..........
..H.....X.
..........
..........
.....E....
..........
.M.......N
..........
..........
.....G....