..........
..X.....G.
..........
..........
.....H....
..........
.N.......M
..........
..........
.....E....