..........
..X.....N.
..........
..........
.....G....
..........
.H.......M
..........
..........
.....E....