..........
..H.....G.
..........
..........
.....E....
..........
.M.......N
..........
..........
.....X....