..........
..H.....G.
..........
..........
.....N....
..........
.X.......M
..........
..........
.....E....