..........
..N.....M.
..........
..........
.....H....
..........
.E.......X
..........
..........
.....G....