..........
..M.....X.
..........
..........
.....N....
..........
.G.......H
..........
..........
.....E....