..........
..M.....E.
..........
..........
.....N....
..........
.X.......H
..........
..........
.....G....