..........
..H.....G.
..........
..........
.....N....
..........
.X.......E
..........
..........
.....M....