..........
..N.....G.
..........
..........
.....E....
..........
.M.......X
..........
..........
.....H....