..........
..G.....M.
..........
..........
.....H....
..........
.N.......X
..........
..........
.....E....