..........
..X.....G.
..........
..........
.....E....
..........
.M.......H
..........
..........
.....N....