..........
..H.....X.
..........
..........
.....M....
..........
.N.......E
..........
..........
.....G....