..........
..M.....E.
..........
..........
.....G....
..........
.X.......N
..........
..........
.....H....