..........
..H.....M.
..........
..........
.....E....
..........
.X.......G
..........
..........
.....N....