..........
..N.....M.
..........
..........
.....E....
..........
.H.......X
..........
..........
.....G....