..........
..N.....E.
..........
..........
.....X....
..........
.M.......H
..........
..........
.....G....