..........
..M.....N.
..........
..........
.....G....
..........
.E.......H
..........
..........
.....X....