..........
..M.....E.
..........
..........
.....H....
..........
.N.......G
..........
..........
.....X....