..........
..G.....M.
..........
..........
.....E....
..........
.H.......N
..........
..........
.....X....