..........
..G.....M.
..........
..........
.....H....
..........
.N.......E
..........
..........
.....X....