..........
..E.....G.
..........
..........
.....N....
..........
.H.......M
..........
..........
.....X....