..........
..E.....G.
..........
..........
.....H....
..........
.X.......M
..........
..........
.....N....