..........
..N.....E.
..........
..........
.....H....
..........
.X.......M
..........
..........
.....G....