..........
..N.....E.
..........
..........
.....X....
..........
.H.......G
..........
..........
.....M....