..........
..M.....E.
..........
..........
.....H....
..........
.N.......X
..........
..........
.....G....