..........
..M.....X.
..........
..........
.....E....
..........
.N.......H
..........
..........
.....G....