..........
..X.....G.
..........
..........
.....E....
..........
.N.......H
..........
..........
.....M....