..........
..E.....N.
..........
..........
.....M....
..........
.H.......X
..........
..........
.....G....