..........
..E.....H.
..........
..........
.....M....
..........
.N.......X
..........
..........
.....G....