..........
..M.....G.
..........
..........
.....X....
..........
.N.......E
..........
..........
.....H....