..........
..H.....E.
..........
..........
.....N....
..........
.M.......G
..........
..........
.....X....