..........
..E.....G.
..........
..........
.....X....
..........
.N.......M
..........
..........
.....H....