..........
..G.....E.
..........
..........
.....M....
..........
.X.......N
..........
..........
.....H....