..........
..N.....E.
..........
..........
.....M....
..........
.G.......X
..........
..........
.....H....