..........
..M.....H.
..........
..........
.....X....
..........
.N.......G
..........
..........
.....E....