..........
..M.....E.
..........
..........
.....H....
..........
.X.......G
..........
..........
.....N....