..........
..G.....M.
..........
..........
.....N....
..........
.H.......E
..........
..........
.....X....