..........
..N.....X.
..........
..........
.....H....
..........
.E.......G
..........
..........
.....M....