..........
..H.....N.
..........
..........
.....M....
..........
.X.......G
..........
..........
.....E....