..........
..E.....X.
..........
..........
.....M....
..........
.N.......G
..........
..........
.....H....