..........
..M.....X.
..........
..........
.....E....
..........
.H.......G
..........
..........
.....N....