..........
..M.....X.
..........
..........
.....H....
..........
.E.......G
..........
..........
.....N....