..........
..M.....X.
..........
..........
.....H....
..........
.N.......E
..........
..........
.....G....