..........
..H.....E.
..........
..........
.....M....
..........
.X.......N
..........
..........
.....G....