..........
..M.....E.
..........
..........
.....X....
..........
.H.......G
..........
..........
.....N....