..........
..X.....H.
..........
..........
.....N....
..........
.G.......M
..........
..........
.....E....