..........
..G.....M.
..........
..........
.....X....
..........
.E.......N
..........
..........
.....H....