..........
..H.....X.
..........
..........
.....E....
..........
.N.......M
..........
..........
.....G....