..........
..M.....G.
..........
..........
.....N....
..........
.E.......X
..........
..........
.....H....