..........
..X.....E.
..........
..........
.....N....
..........
.G.......H
..........
..........
.....M....