..........
..N.....G.
..........
..........
.....E....
..........
.M.......H
..........
..........
.....X....