..........
..E.....G.
..........
..........
.....H....
..........
.X.......N
..........
..........
.....M....