..........
..X.....E.
..........
..........
.....H....
..........
.G.......N
..........
..........
.....M....