..........
..X.....E.
..........
..........
.....N....
..........
.M.......H
..........
..........
.....G....