..........
..X.....M.
..........
..........
.....E....
..........
.H.......N
..........
..........
.....G....