..........
..N.....E.
..........
..........
.....X....
..........
.H.......M
..........
..........
.....G....