..........
..E.....H.
..........
..........
.....X....
..........
.G.......M
..........
..........
.....N....