..........
..M.....G.
..........
..........
.....E....
..........
.X.......H
..........
..........
.....N....