..........
..N.....G.
..........
..........
.....M....
..........
.E.......H
..........
..........
.....X....