..........
..G.....X.
..........
..........
.....N....
..........
.M.......E
..........
..........
.....H....