..........
..E.....G.
..........
..........
.....M....
..........
.X.......H
..........
..........
.....N....