..........
..X.....G.
..........
..........
.....H....
..........
.M.......E
..........
..........
.....N....