..........
..X.....G.
..........
..........
.....N....
..........
.H.......M
..........
..........
.....E....