..........
..M.....X.
..........
..........
.....G....
..........
.E.......N
..........
..........
.....H....