..........
..H.....N.
..........
..........
.....E....
..........
.G.......M
..........
..........
.....X....