..........
..X.....G.
..........
..........
.....H....
..........
.E.......N
..........
..........
.....M....