..........
..M.....X.
..........
..........
.....N....
..........
.E.......H
..........
..........
.....G....