..........
..N.....M.
..........
..........
.....X....
..........
.G.......H
..........
..........
.....E....