..........
..G.....H.
..........
..........
.....M....
..........
.E.......N
..........
..........
.....X....