..........
..G.....X.
..........
..........
.....E....
..........
.H.......M
..........
..........
.....N....