..........
..H.....G.
..........
..........
.....M....
..........
.E.......N
..........
..........
.....X....