..........
..X.....H.
..........
..........
.....E....
..........
.M.......G
..........
..........
.....N....