..........
..N.....G.
..........
..........
.....E....
..........
.X.......M
..........
..........
.....H....