..........
..G.....N.
..........
..........
.....H....
..........
.E.......X
..........
..........
.....M....