..........
..H.....G.
..........
..........
.....N....
..........
.E.......M
..........
..........
.....X....