..........
..N.....X.
..........
..........
.....E....
..........
.M.......H
..........
..........
.....G....