..........
..G.....M.
..........
..........
.....H....
..........
.E.......X
..........
..........
.....N....