..........
..H.....X.
..........
..........
.....N....
..........
.M.......G
..........
..........
.....E....