..........
..E.....M.
..........
..........
.....N....
..........
.X.......H
..........
..........
.....G....