..........
..N.....E.
..........
..........
.....G....
..........
.X.......H
..........
..........
.....M....