..........
..M.....G.
..........
..........
.....E....
..........
.N.......X
..........
..........
.....H....