..........
..X.....E.
..........
..........
.....M....
..........
.N.......H
..........
..........
.....G....