..........
..X.....N.
..........
..........
.....G....
..........
.M.......H
..........
..........
.....E....