..........
..H.....N.
..........
..........
.....X....
..........
.E.......G
..........
..........
.....M....