..........
..N.....H.
..........
..........
.....G....
..........
.M.......X
..........
..........
.....E....