..........
..M.....E.
..........
..........
.....X....
..........
.G.......N
..........
..........
.....H....