..........
..H.....N.
..........
..........
.....G....
..........
.M.......X
..........
..........
.....E....