..........
..X.....G.
..........
..........
.....M....
..........
.H.......N
..........
..........
.....E....