..........
..X.....N.
..........
..........
.....G....
..........
.E.......M
..........
..........
.....H....