..........
..H.....G.
..........
..........
.....E....
..........
.X.......N
..........
..........
.....M....