..........
..E.....X.
..........
..........
.....G....
..........
.H.......M
..........
..........
.....N....