..........
..N.....M.
..........
..........
.....H....
..........
.E.......G
..........
..........
.....X....