..........
..X.....G.
..........
..........
.....N....
..........
.E.......H
..........
..........
.....M....