..........
..G.....E.
..........
..........
.....N....
..........
.M.......H
..........
..........
.....X....