..........
..X.....E.
..........
..........
.....M....
..........
.N.......G
..........
..........
.....H....