..........
..N.....X.
..........
..........
.....H....
..........
.E.......M
..........
..........
.....G....