..........
..E.....N.
..........
..........
.....H....
..........
.X.......G
..........
..........
.....M....