..........
..M.....G.
..........
..........
.....X....
..........
.N.......H
..........
..........
.....E....