..........
..X.....H.
..........
..........
.....N....
..........
.E.......G
..........
..........
.....M....