..........
..H.....X.
..........
..........
.....G....
..........
.E.......M
..........
..........
.....N....