..........
..X.....H.
..........
..........
.....M....
..........
.G.......E
..........
..........
.....N....