..........
..H.....E.
..........
..........
.....G....
..........
.N.......X
..........
..........
.....M....