..........
..N.....X.
..........
..........
.....M....
..........
.H.......E
..........
..........
.....G....