..........
..G.....X.
..........
..........
.....H....
..........
.M.......N
..........
..........
.....E....