..........
..G.....N.
..........
..........
.....X....
..........
.H.......M
..........
..........
.....E....