..........
..N.....G.
..........
..........
.....X....
..........
.H.......E
..........
..........
.....M....