..........
..N.....E.
..........
..........
.....H....
..........
.M.......G
..........
..........
.....X....