..........
..G.....N.
..........
..........
.....H....
..........
.X.......M
..........
..........
.....E....