..........
..G.....N.
..........
..........
.....H....
..........
.M.......E
..........
..........
.....X....