..........
..X.....M.
..........
..........
.....G....
..........
.N.......E
..........
..........
.....H....