..........
..N.....M.
..........
..........
.....X....
..........
.H.......G
..........
..........
.....E....