..........
..H.....N.
..........
..........
.....G....
..........
.M.......E
..........
..........
.....X....