..........
..E.....N.
..........
..........
.....H....
..........
.X.......M
..........
..........
.....G....