..........
..G.....X.
..........
..........
.....H....
..........
.N.......E
..........
..........
.....M....