..........
..X.....N.
..........
..........
.....M....
..........
.G.......E
..........
..........
.....H....