..........
..G.....M.
..........
..........
.....N....
..........
.X.......E
..........
..........
.....H....