..........
..H.....G.
..........
..........
.....X....
..........
.N.......E
..........
..........
.....M....