..........
..N.....X.
..........
..........
.....M....
..........
.G.......H
..........
..........
.....E....