..........
..H.....N.
..........
..........
.....G....
..........
.X.......E
..........
..........
.....M....