..........
..H.....M.
..........
..........
.....G....
..........
.E.......N
..........
..........
.....X....